####S################
###...####........###
#...#.###..##.###.#.#
###.......###.#.#.#.#
#.##.#####..........#
#.#.....####.##.##.##
##..###.#.##.###....#
#######........###.##
#..####.####.#####.##
####.##.######...#..#
##.#.#......##..##.##
#..#.####..#####...##
##.#.............####
#####################